11111111111111111
100010010001001E1
1C100000000000101
10101111000010101
10110110001110001
10100011000110101
101000011C1100101
10010000111000101
1P0100000100001C1
11111111111111111