1111111111111111
100C00111100C1E1
1011100111010101
1010110000010001
1P001C0100011111
1111111111111111